stage,r_desc,product_content,mail_content,mission1,mission2,mission3
1150101,심연,,700001;60000,1,1,1
1150107,,,700001;15000,1,1,1
1150207,,,700001;15000,1,1,1
1150307,,,700001;15000,1,1,1
1150407,,,700001;15000,1,1,1
1150507,,,700001;15000,1,1,1
1150607,,,700001;15000,1,1,1
1150707,,,700001;15000,1,1,1
1150807,,,700001;15000,1,1,1
1150907,,,700001;15000,1,1,1
1151007,,,700001;15000,1,1,1
1151107,,,700001;15000,1,1,1
1151207,,,700001;15000,1,1,1