stage,r_desc,product_content,mail_content,mission1,mission2,mission3
1160101,심연 1,,700001;60000,1,1,1
1160107,,,700001;15000,1,1,1
1160207,,,700001;15000,1,1,1
1160307,,,700001;15000,1,1,1
1160407,,,700001;15000,1,1,1
1160507,,,700001;15000,1,1,1
1160607,,,700001;15000,1,1,1
1160707,,,700001;15000,1,1,1
1160807,,,700001;15000,1,1,1
1160907,,,700001;15000,1,1,1
1161007,,,700001;15000,1,1,1
1161107,,,700001;15000,1,1,1
1161207,,,700001;15000,1,1,1